########   #########
#                  #
# ##             # #
#                  #
       ####         
                    
#           ##     #
#    #             #
#                 /#
######       #######
