####################
#                  #
# ##             # #
#                  #
#      ####        # 
#                  # 
#           ##     #
#    #             #
#                 /#
####################
