####################
#                  #
#                  #
#                  #
#                  # 
#                  # 
#                  #
#                  #
#                 /#
####################
